author=Manuestaire & matrix033
prefix=[Stargate] 
teleportMsg=Teletransportado
destroyMsg=Portal Destruído
invalidMsg=Destino no Valido
blockMsg=Destino Bloqueado
destEmpty=Lista de Destinos Vacía
denyMsg=Acceso Denegado
spawnBlockMsg=Des sections d'apparition interfèrent avec ce portail.

ecoDeduct=Descontado %cost%
ecoRefund=Reembolsado %cost%
ecoObtain=Obtenido %cost% del portal %portal%
ecoInFunds=No tienes suficiente dinero

createMsg=Portal creado
createNetDeny=No tienes acceso a esta red
createGateDeny=No tienes acceso a este diseño de portal
createPersonal=Creando el portal en una red personal
createNameLength=Nombre demasiado largo o demasiado corto
createExists=Ya existe una puerta con este nombre
createFull=Esta red está llena
createWorldDeny=No tienes permisos para acceder a ese mundo
createConflict=El portal entra en conflicto con un portal ya existente

signRightClick=Click derecho
signToUse=para usar
signRandom=Aleatorio
signDisconnected=Desconectado

bungeeDisabled=Soporte de BungeeCord desactivado.
bungeeDeny=No tienes permiso para crear porteles de BungeeCord.
bungeeEmpty=Portales de BungeeCord requieren ambos una red y un destino.
bungeeSign=Teletransportado a
