author=TheProbleemm
prefix=[Stargate] 
teleportMsg=Voce foi teleportado.
destroyMsg=Portal destruido.
invalidMsg=Destino Nao conectado/invalido.
blockMsg=Destino bloqueado.
destEmpty=Lista de destino vazia.
denyMsg=Acesso negado. Voce nao tem permissao.
spawnBlockMsg=os pedaços de desova estão interferindo neste portal.

ecoDeduct=O teleporte custou: R$ %cost%.
ecoRefund=Voce foi reembolsado: R$ %cost%.
ecoObtain=Foi obtido R$ %cost% do portal %portal%.
ecoInFunds=Fundos insuficientes.

createMsg=Portal criado.
createNetDeny=Voce nao tem acesso a essa rede.
createGateDeny=Voce nao tem acesso a esse portal layout.
createPersonal=Criando portal em rede pessoal.
createNameLength=Nome muito curto ou muito grande.
createExists=Já existe um portal com esse nome.
createFull=Esta rede esta cheia.
createWorldDeny=Voce nao tem acesso a esse mundo.
createConflict=Portal em conflito com um portal ja existente.

signRightClick=Clique direito
signToUse=usar o portão
signRandom=Aleatória
signDisconnected=Desconectado

bungeeDisabled=Tradução Necessária
bungeeDeny=Tradução Necessária
bungeeEmpty=Tradução Necessária
bungeeSign=Tradução Necessária
